MMMMMMMMMMMMMMMMMMMMMMMMMMMMMMMMMMMMMMMMMMMMMMMMMMMMMMMMMMMMMMMMMMMMMMMMMMMMMMMMMMMMMMMMMMMMMMMMMMMMMMMMMMMMMMMMMMMMMMMMMMMMMMMMMMMMMMMMMMMMMMMMMMMMMMMMMMMMMMMMMMMMMMMMMMMMMMMMMMMMMMMMMMMMMMMMMMMMMMMMMMMMMMMMMMMMMMMMMMMMMMMMMMMMMMMMMMMMMMMMMMMMMMMMMMMMMMMMMMMMMMMMMMMMM
                                   MMMMMMMMMMMM                       MMMMMMMMMMMMMMMMMMMMMMMM     MMMMMMMMMMMM                                     MMMM    MMMMMMMMMM                                                                                        MMMMMMMMMMMMMMM
                                 MMMMMMMMMMMMMMMM              MMMMMMMMMMMMMMMMMMMMMMMMMMMMMMM     MMMMMMMMMMMM                     MM         MMMM            MMMMMMM               MMMMMM         MM  MMM  MMMMMMMMMMMMMMMMMMMMMMMMMMMMMM                   MMMMMMMMMMMMMMM
                              MMMMMMMMMMMMMMMMMMMMMM     MM           MMMMMMMMMMMMMMMMMMMMMMMM     MMMMMMMMMMMM                   MMMM    MMMM           MMM   MMMMMMM          MMMMMMMMMMM      MM                                        MMMMM              MMMMMMMMMMMMMMM
MMMMMMMMMMMMMMMMMMMMMMMMMMMMMMMMMMMMMMMMMMMMMMMMMMMMMMMM    MMMMMMMMMMMMMMMMMMMMMMMMMMMMMMMMMM     MMMMMMMMMMMMMMMMMMMMMMMMMMMMMMMMMMM                         MMMMMMM MMMMMMMM MMMMMMMMMMM   MM                                               MMMMMMMMMMMMMMMMMMMMMMMMMMMMMM